lukio- ja yliopisto-opinnot|high school and university studies
lukuvuoden alku|beginning of school year
yläaste, yläkoulu (grades 7-9)|junior high, middle school
lukio|high school
lukiolainen|high school student
lukion ensimmäinen luokka|first year of high school
lukion toinen luokka|second year of high school
lukion kolmas luokka|final year of high school
ylioppilaskoe|baccalaureate exam
ylioppilas|student who has passed the bac
sisäänpääsykoe|competitive entrance exam
ammattikoulu, ammattikorkeakoulu, yliopisto|college, university
taideyliopisto, kuvataideakatemia|school of fine arts
humanistinen tiedekunta|school of humanities/liberal arts
lääketieteellinen tiedekunta|school of medicine
farmasian laitos|school of pharmacy
luonnontieteellinen tiedekunta|school of sciences
oikeustieteellinen tiedekunta|law school
kauppakorkeakoulu|business school
huippuyliopistot|elite professional schools
asuntola|dormitory
yliopiston kahvila|university cafeteria
kahvila|cafeteria
auditorio|amphitheater
luokkahuone, luokka|classroom
(matematiikan jne.) tunti|a class (math class...)
luento|large lecture class
laboratorio / labra|laboratory / lab
kirjasto|library
läksy|homework
essee|student paper
suullinen esitelmä|oral presentation
koe|test, exam
arvosana|grade
tulokset|results, grades
todistus|grade report
lukujärjestys|schedule
opiskelijakortti|student ID card
harjoittelu|internship
tutkinto|a diploma, degree
oppiaineet ja tunnit|subjects and classes
arkkitehtuuri|architecture
taide|art
piirustus, suunnittelu|drawing, design
musiikki|music
maalaus|painting
viestintä|communications
kirjanpito|accounting
laki, oikeustiede|law
taloustiede|economics
maantiede|geography
historia|history
tietojenkäsittelytiede|computer science
kielet|languages
kiina|Chinese
saksa|German
englanti|English
espanja|Spanish
ranska|French
italia|Italian
latina|Latin
kielitiede|linguistics
kirjallisuus|literature
matematiikka / matikka (informal)|math
lääketiede|medicine
farmasia|pharmacy
filosofia|philosophy
psykologia|psychology
biologia|biology
kemia|chemistry
fysiikka|physics
valtiotiede|political science
sosiologia|sociology
adjektiivit|adjectives
täysi, kiireinen|full, busy (referring to schedule)
kiireinen|busy
seuraava|next
edellinen|last
verbit|verbs
rekisteröityä, ilmoittautua (yliopistoon, filmikerhoon ...)|to register, enroll (in university, film club ...)
maksaa (lukukausimaksu)|to pay (one’s tuition/fees)
Mikä on pääaineesi?|What's your major?
käydä (kurssia)|to take (a course), to follow
mennä luennolle|to attend class
tehdä läksyt|to do one’s homework
ponnistella, nähdä vaivaa|to make an effort
parantaa, kehittyä|to improve
oppia, ottaa selvää, saada tietoa|to find out about, to get information
oppia|to learn
ymmärtää|to understand
tehdä koe|to take an exam
läpäistä koe, päästä läpi kokeesta|to pass (an exam), to succeed (in)
onnistua (jossakin)|to succeed at ...
saada hyväksytty arvosana, päästä läpi|to receive a passing grade
valmistua|to graduate, to complete one’s studies
olla hyvä (jossakin)|to be good in/at ...
olla huono (jossakin)|to be bad in/at ...
olla surkea (jossakin)|to suck in/at ...
lannistua|to be discouraged
olla poissa tunnilta, lintsata/pinnata (informal)|to skip a class
epäonnistua, reputtaa (informal)|to fail
jäädä luokalle, uusia kurssi|to repeat a grade/course
lopettaa (jokin), lähteä (jostakin)|to leave (something, someone or some place)
